###############                     ###############
###############                     ###############
#.............#                     #.............#
#.............#                     #.....###.....#
#.............#                     #.....###.....#
#.............##############        #.............#
#.............##############        #.............#
#..........................###############...###########
#..........................###############...###########
#......................................................#
#......................................................#
#......................................................#
#..........................###############...###########
#..........................###############...###########
#..........................#        #.............#
#.............##############        #.............#
#.............##############        #.............#
#.............#                     #.............#
#.............#                     #.............#
#...###########                     #...###########
#...###########                     #...###########
#...#                               #...#
#...#                               #...#
#...#################################...################
#...#################################...################
#......................................................#
#......................................................#
#......................................................#
########################################################
########################################################
