###############
###############
#.............#
#.............#
#...#####.....#
#...#####.....#
#.......#.....#
#.......#.....#
#.......#.....#
#.......#.....#
#.............#
#.............#
#.............#
###############
###############
