##################################
##################################
#................................#
#................................#
#................................#
#......########....########......#
#......########....########......#
#......####............####......#
#......####............####......#
#......########....########......#
#......########....########......#
#................................#
#................................#
#................................#
################..################
################..################
#................................#
#................................#
#................................#
##################################
##################################
