###########        ###########
###########        ###########
#.........#        #.........#
#.........#        #.........#
#.........##########.........#
#.........##########.........#
#............................#
#............................#
#............................#
#.........##########.........#
#.........##########.........#
#.........#        #.........#
#.........#        #.........#
#.........#        #.........#
#.........#        #.........#
#.........#        #.........#
#.........#        #.........#
###########        ###########
###########        ###########
