#######################
#######################
#.....................#
#...#####.....#####...#
#...#####.....#####...#
#...#####.....#####...#
#.....................#
#.....................#
#.....................#
#...#####.....#####...#
#...#####.....#####...#
#...#####.....#####...#
#.....................#
#.....................#
#.....................#
#...#####.....#####...#
#...#####.....#####...#
#...#####.....#####...#
#.....................#
#######################
#######################
