###################################
###################################
#................#................#
#.................................#
#.................................#
#................#................#
###################################
###################################
