##################
##################
#................#
#....##....##....#
#....##....##....#
#....##....##....#
#....##....##....#
#....##....##....#
#....##....##....#
#................#
##################
##################
