############################
############################
#..........................#
#..........................#
#...#......................#
#...#......................#
#...####################...#
#...####################...#
#..........................#
#..........................#
#......####.....####.......#
#......####.....####.......#
#..........................#
#..........................#
############################
############################
