##################################
##################################
#................................#
#................................#
#................................#
#................................#
#.......########.................#
#.......########.................#
#.......########.................#
#.......########.................#
#................................#
#................................#
#................................#
#................................#
#.................#######........#
#.................#######........#
#.................#######........#
#................................#
#................................#
##################################
##################################
