###################################
###################################
#...............####..............#
#.................................#
#.................................#
#...............####..............#
###################################
###################################
