              ######
              ######
              #....#
              #....#
             ##....##
##############......##############
#############........#############
#................................#
#................................#
#############........#############
##############......##############
             ##....##
              #....#
              #....#
              ######
              ######
