############################
############################
#..........................#
#..........................#
####################.......#
####################.......#
####################.......#
#..........................#
#..........................#
#.......####################
#.......####################
#.......####################
#..........................#
#..........................#
############################
############################
