###############
###############
#.............#
#.............#
#......##.....#
#......##.....#
#.............#
#.............#
#.............#
#.............#
#...###.......#
#...###.......#
#.............#
###############
###############
